------x-----
-xxx--x-----
--Ox--------
---x---xxx--
---x---x----
---x---x----
---x---x-D--
-------x----
