----------------------------------------
------------------x---------------------
-----------------xOx--------------------
-----------------x-xx-------------------
-----------------x--x-------------------
------------------x--x------------------
-------------------x--x-----------------
------------------xxx--x----------------
-----------------x---x--x---------------
-----------------x-x--x--x--------------
-----------------x--x--x--x-------------
-----------------x---x--x--x------------
------------------xx--x--x--x-----------
-----------------x-----x--x--x----------
-----------------x-xxxxxx--x--x---------
-----------------x-------x--x--x--------
------------------xxxxxx--x--x--x-------
-----------------x---------x--x--x------
-----------------x-xxxxxxxxxx--x--x-----
-----------------x-----------x--x--x----
------------------xxxxxxxxxx--x--x--x---
--------------------x---x---x--x--x--x--
------------------x-x-x-x-x--x--x--x--x-
------------------x---x---x----x-x---xD-
